--------------
-ooo.---------
-oSoooo-------
-ooo---ooo----
--ooooooooo---
-------ooToo--
-------ooo----
--------------
