--------------
-ooo.---------
-oSoooo-------
-ooooooooo----
--ooooooooo---
-------ooToo--
-------ooo----
--------------